11111111111
10000000C01
10P00000001
100000001E1
11111111111
10000111001
10100011001
10000001001
11111111111