1111111111111111
1000C0P000E00001
1111111111111111