11111111111
10000000C01
10P00000001
100000000E1
10000000001
10000000001
10000000001
11111111111