111111
100001
10PC01
100CE1
111111