111111
100C01
10P001
1000E1
111111