11111111111
10000000C01
10P00000001
100000000E1
10000111001
10100011001
10000001001
11111111111